SO ./path_to_the_south_texture
                              
                          





WE ./path_to_the_west_texture
EA ./path_to_the_east_texture
NO         ./path_to_the_north_texture 


F             220,100,0
C 225,30,0





11111111111111111111111111111111111111111111111111
11110000000001000000000000000000000000000000000001
10000001 10000010000000000101000100000000000000001
10000001111111000000000001000000000000000000000001
10000000000000000011000000000100000000001100000001
10000000000000001100111000001010000000001100000001
10000100000000110000000110000100000000001100000001
10000110000011000000000001000000000000001100000001
10000101000010000000000000100000000000001100000001
10000101000100000000011000100000000000001100000001
10000100100100000000011000010000000000001100000001
10000100111000000000000000001000000000000000000001
10000100000000000N00100000001000000000000000000001
10000100111000000000100000001000000000000000000001
10000100100100000000010000001000000000000000000001
10000101000100000000001000010000000000000000000001
10000101000010000000000111100000000000000000000001
1000011000001100000000000100000000000000000000000111111111111111111111111
1000010000000011000000001100000000000000000000000000000000000000000000001
1000000000000000110011110000000000000000000000000000000000000000000000001
1000000000000000001100000000000000000000000000000111111111111111111111111
10000000000000000000000000000000000000000000000001
10000000000000000000000000011111111111111111111111
100000000000000000000000001
100000000000000000000000001
10000000000000000000000000011111111111111111111111
10000000000000000000000000000000000000000000000001
10000000000000000000000000000000000000000000000001
10000000000001111000000000000000000000000000000001
10000000000001  1000000000000000000000000000000001
10000000000001  1000000000000000000000000000000001
10000000000001  1000000000000000000000000000000001
10000000000001  1000000000000000000000000000000001
10000000000001111000000000000000000000000000000001
10000000000000000000000000000000000000000000000001
10000000000000000000000000000000000000000000000001
10000000000000000000000000000000000000000000000001
10000000000000000000000000000000000000000000000001
11111111111111111111111111111111111111111111111111
