SO ./path_to_the_south_texture
                              
                          






WE ./path_to_the_west_texture
EA ./path_to_the_east_texture
NO         ./path_to_the_north_texture 


F             220,100,0
C 225,30,0

11111111111  11111111111111111111      
10000000001  10000000000010000001
10000000001  10000000000101000101
100000000011110000000000010000001
100000000000000000110000000001001
100000000000000011001110000010101
100001000000001100000001100001001
100001100000110000000000010000001
100001010000100000000000001000001
100001010001000000000110001000001
100001001001000000000110000100001
100001001110000000000000000010001
100001000000000000001000000010001
100001001110000000001000000010001
100001001001000000000100000010001
100001010001000000000010000100001
100001010000100000000001111000001
100001100000110000000000010000001
100001000000001100000000110000001
100000000000000011001111000000001
100000000000000000110000000000001
100000000000000000000000000000001
100000000000000000000000000000001
100000000000000000000000000000001
111111111111111111111111111111111